#wall address :
SO	./sprites/tmongell.xpm
EA	./sprites/gphilipp.xpm
NO	./sprites/cmaroude.xpm
WE	./sprites/achansel.xpm

#ceiling in blue, floor in white 
C	233,239,240
F	2b9cb5

DC	sprites/tac.xpm
DO	sprites/blank.xpm

#the map itself


        11111111111111111111111
      111000D0000000D0000000001
    111000011100000011111111001
  1110000111000000111000E111001
1110000111 11100000000011100001
10000111  111000000011100000111 
10011111111111000111000001111
100000001110000111000000001
100000011100011111111111001
10000000D00000000000000D001
111111111111111111111111111

