#wall address :
SO	./sprites/tmongell.xpm
NO	./sprites/gphilipp.xpm
WE	./sprites/cmaroude.xpm
EA	./sprites/achansel.xpm

#ceiling in blue, floor in white 
C	233,239,240
F	2b9cb5

#the map itself


        11111111111111111111111
      1110000000000000000000001
    111000011100000011111111001
  1110000111000000111000W111001
1110000111 11100000000011100001
10000111  111000000011100000111 
10011111111111000111000001111
100000001110000111000000001
100000011100011111111111001
100000000000000000000000001
111111111111111111111111111

