NO sprites/hq_wood.xpm
SO sprites/hq_ice.xpm
EA sprites/hq_honeycomb.xpm
WE sprites/hq_leaves.xpm

C julia
F julia

1111
10D1
1D01
10D1
1D01
10D1
1D01
10D1
1D01
10D1
1D01
10D1
1D01
10D1
1D01
10D1
1D01
10D1
1D01
10D1
1D01
10D1
1D01
10D1
1D01
10D1
1D01
10D1
1D01
10D1
1D01
10D1
1D01
10D1
1D01
10D1
1D01
10D1
1D01
10D1
1D01
10D1
1N01
1111
