SO	./sprites/wall/spunk_south.xpm
NO	./sprites/wall/spunk_north.xpm
WE	./sprites/wall/spunk_west.xpm
EA	./sprites/wall/spunk_east.xpm

CR	sprites/crosshair_ME1.xm

DC	sprites/spunk_close.xpm
DO	sprites/spunk_open.xpm

F	148.83.50
C	51,255,255

111111111111111111111111111111111111111111
1E000110001000011100D000101000001110000001
10000DD0011001100D001100110011001100000001
11DD11100000000001001100D00100000000111001
100000111110001111111001100110011100111111
1DD10000001000D00010000D000D000D0000001111
100100000001001100011111111111111111111111
100100110001000100011
100111111000111111D11
100110000000100011D11
111111100111100010001
100000D000100000D0001
111D1111111D111011111
100000100000D00000001111111111111111111111
100011111111101111001101011101111101111D11
100000000010100010001100000000011111110001
11D11D1111111DD111111100000000011110010001
10011001D00000000000111111001101111001D001
100110010000000000001100110D00110001110111
1000011000110000100011000001000D0000D00011
111111111111111111111111111111111111111111
