NO ./sprites/basic.xpm
SO ./sprites/basic.xpm
WE ./sprites/basic.xpm
EA ./sprites/basic.xpm

C 26,161,199
F 107,75,85



1111111              1111111
1000001              1000001
1000001              1000001
1000001              1000001
1000001              1000001
1000001              1000001
1000001              1000001
1000001              1000001
1000001              1000001
1000001111111101111111000001
1000000000000000000000000001
1000000000000000000000000001
1000000000000000000000000001
1111111111111111111111111111
